1111111111111111111
10001100101000C0E01
1100100000100100001
100000C00100C001011
110000000000001P101
1100C00001111000001
1111111111111111111