1111111111111111111
100E00101C000100101
1110100000100100001
10000000010000P1011
1111000000000011101
1100010001111100001
1111111111111111111