1111111111111111111
1000000000100000E01
1P00000000100000001
100000C00100C000011
1111111111111111111