111111111111111111111
1PC000000000000000011
1C0000000000000000011
10E0000000000C000C001
11010000000000000C001
11100000000010000C001
111111111111111111111