111111111111111111111
1PC000000000000000011
1C0000000000000000011
10E000000000000000001
110100000000000000001
111000000000100000001
111111111111111111111