111111111111111111111
1PCE0000000E000000011
111111111111111111111