111111
111P01
1CE101
11D001
111111