11111111111111
1PC00000001011
1C000000000011
10E00000000001
11010000000001
11000D0000C001
11111111111111