11111111111111
1PC00000001011
1C000000000111
10E000D00001D1
1D010000000111
11111111111111