111111111111111111111
1PC000000000100000001
1C000000C000000000001
10E000D000000000000C1
10D0100000000000C0011
1D0000000000000000001
111111111111111111111