11111111111111111111
1P01001D100000C100E1
10010000000011111011
1001001D101001000001
100000101C1001011111
10000C11111001010001
1111001C0000C1010001
10010010D00D01010001
100111100CC001010001
10000C10D00D01010001
1111101C0000C1010001
10000011110111010001
1011111C0000C1010001
10000C10111111010001
10000C10100000000001
10111110101111111111
1C0000000000000000C1
1110111D00D111000111
1D100000C00000000C11
11111111111111111111