11111111111111
1PC00000000011
1C000000000011
10E00000000001
11010000000001
11100000000011
11111111111111