11111111111111
1PC00000001011
1C00000D000111
10E00000000001
11010000000001
1D00010000C001
1D000000000001
11111111111111