111111111111111111111111111111111111
10000000000000000000000000000000000C1
10E0000000000111111101111111111111111
10D000000011111111C001111000111111111
100000001111111PC00001000C00111111111
1000011111111C0D0000000000001111111C1
1001111111C0000D000000000111111110001
10111111C000000D000000011111110000001
101111CC000CC0CCCCCC01111111000000001
1011111111111111111101111111000001111
1011111111111111111101111111000111111
1000000000000111111101111111011111111
100C000000000111111100000000000000001
10000000000C011111110D00000C000000001
1111111111111111111111111111111111111