11111111111111
1PC00000001011
1C000000000011
10E00D00000001
11010000000001
1100010000C001
11111111111111