111111
111P01
1CE101
110001
111111